0,0,0,5,3,2,1,3,2,3,2,1,3,1,2,3,5,0,0,0
0,0,0,5,1,2,1,3,1,3,2,1,2,1,2,3,5,0,0,0
0,5,0,0,0,0,0,0,0,0,0,0,0,0,0,0,0,0,5,0
0,5,0,0,0,0,0,0,0,0,0,0,0,0,0,0,0,0,5,0
0,5,0,0,0,0,0,0,0,0,0,0,0,0,0,0,0,0,5,0
0,4,4,4,4,4,4,4,4,4,4,4,4,4,4,4,4,4,4,0
0,0,0,0,0,0,0,0,0,0,0,0,0,0,0,0,0,0,0,0
